1;1;1;1;1;1;1;1;1;1;1;1;1;1;1;1;1;1;1;1
1;0;0;0;0;0;7;0;0;0;0;0;0;0;1;0;0;7;0;1
1;0;1;1;1;1;0;1;1;1;1;1;1;0;1;0;1;1;0;1
1;0;1;7;7;1;0;1;1;1;1;1;1;0;0;0;1;1;0;1
1;0;1;0;0;1;0;0;0;0;1;1;1;1;1;1;1;1;0;1
1;0;1;0;0;1;1;1;1;0;1;1;1;1;1;1;1;1;0;1
1;0;1;0;0;1;1;1;1;0;1;1;1;1;1;1;1;1;0;1
1;0;0;0;0;1;1;1;1;0;1;1;1;1;1;1;1;1;0;1
1;1;1;1;1;1;1;1;0;0;0;1;1;1;1;1;0;7;0;1
1;1;1;1;1;7;0;0;0;3;0;0;0;0;0;0;0;1;1;1
1;1;1;1;1;0;1;1;0;0;0;1;1;1;1;1;1;1;1;1
1;1;1;1;1;5;0;0;1;0;1;1;1;1;3;3;3;3;3;1
1;0;0;0;1;0;0;0;1;0;1;1;1;1;3;3;3;3;3;1
1;0;1;0;0;6;0;0;1;0;1;1;1;1;3;3;1;1;1;1
1;0;1;0;0;0;0;0;1;0;0;0;0;0;3;3;1;2;2;1
1;0;1;1;1;1;1;0;1;7;1;1;1;1;3;3;1;2;2;1
1;7;0;0;0;0;0;0;1;0;1;1;1;1;3;3;1;1;1;1
1;1;1;1;1;1;1;1;1;0;1;1;1;1;3;3;3;3;3;1
1;5;0;0;0;0;0;0;0;0;1;1;1;1;3;3;3;3;3;1
1;1;1;1;1;1;1;1;1;1;1;1;1;1;1;1;1;1;1;1
